{
  "level": -2,
  "map": [
    ["##########"]
    ["#········#"]
    ["#········#"]
    ["#········#"]
    ["#········#"]
    ["#········#"]
    ["#·····P··#"]
    ["#········#"]
    ["#········#"]
    ["#········#"]
    ["##########"]
  ]
}
