##########
#········#
#········#
#········#
#··P·····#
#········#
#········#
#········#
#········#
##########

